XXXXX
XE  X
X XXX
X  SX
XXXXX
