XXXXXXXX
X   X  S
X XXXX X
X   XX X
X X    X
XEXXXXXX

