XXXXXXXXXXXXXXXXXXXXXXXXXXXXXXXXXXXXXXXXSXXXXX
X            XXXXXXXXXXXXXXXXXXXXXXXXXXX  XXXX
X XXXX X X X X   X   XXXXXXXXXXXXXXXXXXX XXXXX
X   XX X X X X X X X                   X XXXXX
X X        X X X X X XXXXXXXXXXXXXXXXXXX XXXXX
X XXXXXXXXXX X X X X XXXXXXXXXXXXXXXXXXX XXXXX
X XXXXXXXXXX X X X X XXXXXXXXXXXXXXXXXXX XXXXX
X XXXXXXXXXX X X X X XXXXXXXXXXXXXXXXXXX XXXXX
X XXXXXXXXXX X X X X                         X
X XXXXXXXXXX X X X X XXXXXXXXXXXXXXXXXXXXXXXXX
X          X X X X X XXXXXXXXXXXXXXXXXXXXXXXXX
XXXXXXXXXX X X X X X XXXXXXXXXXXXXXXXXXXXXXXXX
XXXXXXXXXX X X X X X XXXXXXXXXXXXXXXXXXXXXXXXX
XX         X X X X X XXXXXXXXXXXXXXXXXXXXXXXXX
X  XXXXXXXXX X X X X XXXXXXXXXXXXXXXXXXXXXXXXX
X XXXXXXXXXX X X X X XXXXXXXXXXXXXXXXXXXXXXXXX
X XXXXXXXXXX X X X X XXXXXXXXXXXXXXXXXXXXXXXXX
X XXXXXXXXXX X X   X XXXXXXXXXXXXXXXXXXXXXXXXX
X XXXXXXXXXX   XXXXX XXXXXXXXXXXXXXXXXXXXXXXXX
XEXXXXXXXXXXXXXXXXXXXXXXXXXXXXXXXXXXXXXXXXXXXX